[
  {
    //地圖1, 0代表墻體，1代表陸地，2代表水，3代表玩家重生點（城堡? 復活魔法陣?）
    "MapData": [
      [ 0, 0, 0, 0, 1, 1, 1, 1, 1, 2, 2, 2, 2, 0 ],
      [ 0, 0, 0, 1, 1, 1, 1, 1, 1, 1, 2, 2, 0, 0 ],
      [ 0, 0, 0, 1, 1, 1, 1, 1, 1, 2, 2, 2, 2, 0 ],
      [ 0, 0, 1, 1, 1, 1, 1, 1, 1, 1, 2, 2, 2, 2 ],
      [ 0, 0, 1, 1, 1, 1, 1, 1, 1, 1, 2, 2, 2, 2 ],
      [ 0, 0, 1, 1, 1, 1, 1, 1, 1, 1, 2, 2, 2, 2 ],
      [ 0, 0, 0, 1, 1, 1, 1, 1, 1, 1, 1, 2, 2, 0 ],
      [ 0, 4, 4, 4, 1, 1, 1, 1, 1, 1, 2, 2, 2, 0 ],
      [ 4, 4, 4, 4, 4, 1, 1, 1, 1, 1, 2, 2, 2, 0 ],
      [ 4, 4, 4, 4, 1, 1, 3, 1, 1, 0, 0, 0, 0, 0 ]
    ]
  }
]